tk = tkinter
ttk = tkinter.ttk
np = numpy
pil = PIL
img = PIL.Image
image = PIL.Image
draw = PIL.ImageDraw
mp = matplotlib
ax = matplotlib.axes.Axes
bz = matplotlib.bezier
fig = matplotlib.figure.Figure
figure = matplotlib.figure.Figure
plt = matplotlib.pyplot
plot = matplotlib.pyplot
patch = matplotlib.patches
path = matplotlib.path.Path
polygon = matplotlib.patches.Polygon
box = matplotlib.transforms.Bbox
trans = matplotlib.transforms
cmap = matplotlib.colors.LinearSegmentedColormap

glib = gi.repository.GLib
gobject = gi.repository.GObject 
gdk = gi.repository.Gdk
pixbuf = gi.repository.GdkPixbuf
gio = gi.repository.Gio
gtk = gi.repository.Gtk
pango = gi.repository.Pango
geo = shapely.geometry
poly = shapely.geometry.polygon
line = shapely.geometry.linestring
